-=-
11.22.6=112263
112263=112263
14=14
2666=2666
A=Abarat|Amok|Anathem|Angelfall|Ark|Ash|Audible|Ascendant
AA=ArcaneAscension|AlexanderAdams|AlanArkin|AdeelAkhtar|AssassinsApprentice
AAAOD=AmokAnAudibleOriginalDrama
AADN=AnAlexDelawareNovel
AAFSEVD=AnAmericanFamilyShakespeareEntertainmentVol1Dramatized
AAG=AnActofGod
AAGT=AnAlexanderGregoryThriller
AAH=AnArgumentationofHistorians
AAS=ApprenticeAdeptSeries
AAW=AlicesAdventuresinWonderland
AB=AlyssaBresnahan|AscendantBook1|AshleyBell|AnneBobby|AdamBaldwin|AnnaBentinck|AnthonyBurgess
ABDEW=ABoyhisDogattheEndoftheWorld|ABoyandhisDogattheEndoftheWorld
AC=AllClear|AlteredCarbon|AssassinsCreed|AlexCoombs|AndrewChild|AllanCorduner|AndrewCaldecott|AllanCole|AlanCumming|AgathaChristie|AlexCallister
ACC=AChristmasCarol|ACivilCampaign|ArthurCClarke
ACCCSMB=ACatalogueofCatastropheChroniclesofStMarysBook13
ACCHG=AChristmasCarolHG
ACD=ArthurConanDoyle
ACF=AColumnofFire|AstheCrowFlies
ACK=AClashofKings
ACSWTB=ACrownofSwordsWheelofTimeBook7
AD=AfterDark|AlexDelaware|AngelaDawe|AgeofDeath
ADB=AgainstaDarkBackground|AllegiantDivergentBook3
ADD=ADancewithDragons
ADF=ADangerousFortune
ADMTIBS=ADedicatedManTheInspectorBanksSeriesBook2
ADS=ADarknessatSethanon|ADeepnessintheSky
AE=AgeofEmpyre
AEFB=ArmageddonExpeditionaryForceBook8
AETC=AnEchoofThingstoCome
AEU=AttheEdgeofUncertainty
AF=AgeofFive|AgeoftheFive|AnimalFarm|AnneFlosnik|AssassinsFate
AFC=AFeastforCrows
AFCPSB=AFaceintheCrowdPrimeSuspectBook2
AFN=AFenrisNovel
AG=AmericanGods|AntonGill|AdamGillen|AndrewGross
AGR=AGRiddle
AGT=AGameofThrones|AGiftofTime|AGraveTalent
AH=AllisonHiroto|AlienHonor|AnthonyHorowitz|AimeeHorne|AlanHarris
AHF=AdventuresofHuckleberryFinn
AHHT=AHarryHoleThriller
AHSATB=AHoleintheSkyArkshipTrilogyBook1
AIJT=AudibleInterviewwithJodiTaylor
AIMLN=AnInspectorMcLeanNovel
AIRD=AnInterviewwithRichardDawkins
AIRT=AnIsabellaRoseThriller
AJ=AlvinJourneyman|AlexJennings|AllysonJohnson|AaronJohnston|AvitaJay
AJF=AJFinn
AJNST=AJackNightingaleSupernaturalThriller
AJS=AJScudiere
AKC=AlanaKerrCollins
AKF=AKillingFrost
AKP=AKingfountainPrequel
AL=AnnaLea|AntonLesser|AgeofLegend
ALBFTLF=AgeofLegendBookFourofTheLegendsoftheFirstEmpire
ALD=AgentsofLightDarkness
ALM=ALetterofMary
ALRPGGL=ALitRPGGameLitNovelTheGoodGuys
AM=AlMurray|AnnaMassey|AasifMandvi|AngelaMarsons|ArthurMorey|AgeofMyth|AlanMoore
AMF=AmyMcFadden
AML=AMemoryofLight|AnnMarieLee
AMSR=AManofSomeRepute
AN=AudreyNiffenegger|AxNorman
ANMBN=ANathanMcBrideNovel
AO=AmongOthers|AscendOnline|ArmyofOne
AOAOB=AscendOnlineAscendOnlineBook1
AOFREES=ArmyofOneFREEStarForceNovella
AP=AtticusPriest|AndrewPeterson|AnnePerry|AnnPatchett
APB=APrisonerofBirth
APBSAPS=APlacetoBuryStrangersAtticusPriestSeriesBook2
APS=APerfectSpy|AtticusPriestSeries
AQ=AssassinsQuest
AQM=AQuantumMurder
AR=AndrewRowe|AnthonyRyan|AgathaRaisin|AlastairReynolds|AmbreenRazia
ARIH=AndtheRestIsHistory
ARN=AReckonersNovel
ARQDARB=AgathaRaisintheQuicheofDeathAgathaRaisinBook1
AS=AgenttotheStars|AlienShores|AndrzejSapkowski|AdamSims|AngieSage|AlSmith|AndrewScott|AndySecombe|AlSarrantonio
ASB=ArcanistSpellmongerBook12
ASC=ASecondChance
ASCUK=AudibleSessionsChannelsUK
ASD=ASeasonfortheDead
ASDTRSB=ASeasonfortheDeadTheRomeSeriesBook1
ASE=ASymphonyofEchoes
ASFT=AScienceFictionThriller
ASHNE=AShortHistoryofNearlyEverything
ASIF=ASongofIceandFire
ASS=AStormofSwords
ASTLFEB=AgeofSwordsTheLegendsoftheFirstEmpireBook2
AT=ArkshipTrilogy|AdrianTchaikovsky
ATAP=AnotherTimeAnotherPlace
ATDCIRM=AngelTheDCIRyanMysteriesBook4
ATDL=AThinDarkLine
ATF=AgeofTheFive
ATM=ArmageddonTheMusical
ATMATB=ArmageddonTheMusicalArmageddonTrilogyBook1
ATO=ATimeOdyssey
ATR=AllThatRemains
ATS=ArkshipTrilogySeries|ATrialofSouls
ATTT=ATrailThroughTime
ATW=AllTheseWorlds
AUQ=AnUnwelcomeQuest
AVEM=AVeryEnglishMystery
AW=AlienWars|AlterWorld|AnnaWaterhouse|AndyWeir
AWC=AWarningtotheCurious
AWM=AWantedMan
AWS=AWickedSnow
AWSC=AWildSheepChase
AWTLFEB=AgeofWarTheLegendsoftheFirstEmpireBook3
B=Bobiverse|Barking|Blackout|Belgariad
BA=BlackstoneAudio|BlueAdept|BrokenAngels|BenAaronovitch|BrothersinArms
BAALTRB=BrothersinArmsALegendaryTankRegimentsBloodyWarfromDDaytoVEDay
BAB=BeckyAnnBaker
BADCIRM=BorderlandsADCIRyanMysteryTheDCIRyanMysteriesBook14
BAP=BlakeArthurPeel
BB=BillBryson|BenBova|BlondeBombshell|BrazzavilleBeach|BlackBlue|BillBailey
BBOSC=BenBovaandOrsonScottCard
BBOSCTA=BenBovaOrsonScottCardTheAudibleInterview
BC=BillyCrystal|BriefCases|BenCounter|BernardCornwell|BrianCox
BCWYWF=BeCarefulWhatYouWishFor
BD=BrownDog|BookD|BloodofDragons|BernadetteDunne
BDA=BrianDAnderson
BDP=BookDPodcast
BDW=BoneDustWhite
BE=BloodofElves|BodyofEvidence
BEFB=BrushfireExpeditionaryForceBook11|BreakawayExpeditionaryForceBook12
BF=BloodoftheFold|BrianFreeman|BaptismofFire
BG=BadGuys|BrotherGrimm|BuriedforGood|BerriGeorge
BGS=BadGuysSeries
BGTDFB=BattleGroundTheDresdenFilesBook17
BH=BrokenHarbour|BernhardHennen|BeaHolland
BI=BloodIron|BloodandIron
BJMB=BulletproofJohnMiltonBook20
BKS=BestKeptSecret
BL=BlindLake|BillLord
BLJMB=BrightLightsJohnMiltonBook15
BM=BandsofMourning|BleedforMe
BMJRB=BlueMoonJackReacherBook24
BN=BobNewhart|BillNighy
BNM=Book1oftheNewManagement
BO=BlackOps
BODJRB=BetterOffDeadJackReacherBook26
BP=BronsonPinchot|BrendaPressley
BR=BrandonRubin
BS=BrandonSanderson|BillySummers|BloodSong|BuckSchirner|BrianStaveley|BenStiller
BT=BloodTest
BV=BrokenVeil
BVL=BVLarson
BWSW=BlindWillowSleepingWoman
C=Currency|Calamity|Chainfire|Choice|Cockroaches|Confessor|Convergence|Crosstalk|Cryptonomicon|Crusade|Culture
CA=CraigAlanson|CastleintheAir
CAF=CAFletcher
CAM=CrimesAgainstMagic
CB=CliveBarker|CameronBeierle|ClaudiaBlak|CarolynBonnyman|ColinBateman|ChrisBunch
CBBCRST=ClassicBBCRadioShakespeareTragedies|ClassicBBCRadioShakespeareTragediesHamletMacbethRomeoandJuliet
CC=CliftonChronicles|CrystalCity|ClareCorbett|CharlesCummings|ChrisCarter
CCB=ConvergenceConvergenceBook1
CCTPSTB=ChainfireChainfireTrilogyPart1SwordofTruthBook9
CD=CharlesDickens|CaitlinDavies|CarnivalfortheDead|ColumbusDay|ClareDonoghue|CityofDragons
CE=CareerofEvil|CollectedEdition
CEW=ChristopherEvanWelch
CF=ChronicleoftheFallers|ClaireFuller|theCycleofFire|CharlieFletcher
CG=CorneliusGarrett|CurtGentry|CarolinaGuthrie|CharltonGriffin
CGBSNPC=ConductorsGuidetoBeethovensSymphonyNo5PianoConcertoNo4
CH=ComeththeHour|CeciliaHolland|CynthiaHolloway|ChisaHutchinson|ChuckHogan
CI=CrowInvestigations
CJ=CushJumbo
CJS=CJSkuse
CK=CrookedKingdom|CaitlinKelly|CharlesKeating
CL=ChristopherLane|CharlesLamb|CarolineLee
CLCDCIT=ComeaLittleCloserDCITomDouglasBook7
CM=ColinMorgan|ChildrenoftheMind|ChinaMieville|CruelMiracles|ColinMace|CooperMoo
CMC=CarolynMcCormick|CathleenMcCarron
CMEFB=CriticalMassExpeditionaryForceBook10
CMTDHHB=CruelMiraclesTalesofDeathHopeandHolinessBookFourofMapsinaMirror
CN=ClaireNorth|CaptainNemo|CharlieNorfolk
CNH=CharlieNHolmberg
CO=CarolineOverington
CP=ChrisPatton|ChristmasPresent|ConsiderPhlebas|CarlPrekopp|ChristopherPriest
CR=CraigRussell|CastingtheRunes|ChildrenofRuin|ChristopherRagland|ChristopherRoden|ChristianRummel|ChristianRodska|CrispinRedman|CarnivalRow
CRTD=CarnivalRowTangleintheDark
CS=ClockworkSherlock|CultureSeries|CormoranStrike|CharlesStross|CarrieSeim
CSL=CreatedbyStanLee
CSM=ChroniclesofStMarys
CT=ChaosTheory|ChildrenofTime|CrossroadsofTwilight|CenturyTrilogy|ChinaThriller|CariThomas
CTDCIRM=CragsideTheDCIRyanMysteriesBook6
CTP=CTPhipps
CTTHYP=ColorlessTsukuruTazakiHisYearsofPilgrimage|ColorlessTsukuruTazakiandHisYearsofPilgrimage
CTYT=CloserThanYouThink
CUT=ChronicleoftheUnhewnThrone
CV=CarrieVaughn
CW=CraigWasson|ConnieWillis|CastleofWizardry|ChrisWebster
CWSB=CourtWizardSpellmongerBook8
CWTDCIR=CuthbertsWayTheDCIRyanMysteriesBook17
CWTEB=CalibansWarTheExpanseBook2
CYE=CloseYourEyes
CZ=CodetoZero
D=Deceptions|Declare|Departure|Divergent|Doughnut|Dune|Dust|Discworld|Duplex|Dragonvein
DA=DragonflyinAmber|DrumsofAutumn|DanAbnett
DAB=DavidAaronBaker
DAMN=DuplexAMicropowersNovel
DATDCB=DragonsofAutumnTwilightDragonlanceChroniclesBook1
DB=DavidBirney|DoomsdayBook|DryBones|DavidBauckham|DavidBaldacci|DavidBrin|DryadBorn|DragonveinBook1
DBF=DragonveinBookFour|DragonveinBookFive
DBS=DaysofBloodStarlight
DBT=DragonveinBookTwo|DragonveinBookThree
DC=DragonlanceChronicles|DavidColacci|DonaldCorren|DavidCollings
DCIR=DCIRyan
DCITD=DCITomDouglas
DD=DavidDuchovny
DDB=DragonveinDragonveinBook1
DDD=DanceDanceDance
DDM=DaphneDuMaurier
DDTWBMB=DefyingDestinyTheWarofBrokenMirrorsBook3
DE=DavidEddings|DeathstalkerEpisode1|DeathstalkerEpisode2|DeathstalkerEpisode3|DeathstalkerEpisode4|DeathstalkerEpisode5
DEFEA=DeathstalkerEpisode2FriendsEnemiesandAllies
DEFMB=DeathtrapExpeditionaryForceMavericksBook1
DET=DennisETaylor
DEUATC=DeathstalkerEpisode3UndertheAshesTheCity
DF=DavidFreeman|DarkForces|DomesofFire|DavidFrench
DFG=DanielFGalouye
DG=DianaGabaldon|DinaGregory|DeadhouseGates
DGM=DreamsofGodsMonsters
DGTB=DemonGaeanTrilogyBook3
DGTMBF=DeadhouseGatesTheMalazanBookoftheFallen2
DGWB=DragonsGreenWorldquakeBook1
DH=DavidHewson|DickHill|DrewHayes|DragonHaven|DavidHorovitch|DominicHoffman
DIML=DIMikeLockyer
DJ=DavidJaverbaum|DanJolley
DK=DeanKoontz|DragonKeeper|DetectiveKim|DerekKunsken|DanielKraus
DL=DavidLedoux|DamianLewis|DamianLynch|DavidLevithan|DavidLagercrantz|DavidLevine
DLD=DavidLeDoux
DLDBNMA=DeadLiesDreamingBook1oftheNewManagementAnewadventurebeginsintheworldoftheLaundryFiles
DLECB=DarkLightElizabethCageBook2
DLK=DemonLordofKaranda
DM=DanseMacabre|DeadMen|DavidMorse|DirkMaggs
DMABVHB=DanseMacabreAnitaBlakeVampireHunterBook14
DMC=DeanMCole
DMS=DublinMurderSquad
DMSSBCM=DrMorganSnowwithSteveBerrysCottonMalone
DO=DanielOreskes
DOH=DenisOHare
DP=DerekPerkins|DavinaPorter|DanielPhilpott|DinaPearlman|DarkPaladin
DPS=DarkPaladinSeries
DR=DRus|DavidRamirez
DRE=DeathstalkerRebellionEpisode1|DeathstalkerRebellionEpisode2|DeathstalkerRebellionEpisode3|DeathstalkerRebellionEpisode4|DeathstalkerRebellionEpisode5
DS=DavidSuchet|DanShepherd|DeepSecret|DimensionSpace|DoctorSleep|DanSimmons|DanielSuarez
DSB=DaughterofSmokeBone|DaughterofSmokeandBone
DSBT=DaughterofSmokeandBoneTrilogy
DSD=DragonsofSpringDawning
DSTDCIR=DarkSkiesTheDCIRyanMysteriesBook7
DT=DavidThorpe|DavidTennant|DemonTrilogy
DTTPB=DoingTimeTimePoliceBook1
DU=DarkUniverse
DW=DangerousWomen|DawnofWonder|DavidWeber|DominicWest|DanWells
DWE=DeathstalkerWarEpisode1|DeathstalkerWarEpisode2|DeathstalkerWarEpisode3|DeathstalkerWarEpisode4|DeathstalkerWarEpisode5
DWJ=DianaWynneJones
DWNDCB=DragonsofWinterNightDragonlanceChroniclesBook2
E=Excession|Episode1|Episode4|Episode5|Elantris|Emma|Enchantment|Enchantress|Eon|Eternity|Extracted|Excalibur
EA=EssencersofAelathia
EAABS=EssencersofAelathiaA3in1BookSeries
EAFC=EarthAirFireCustard|EarthAirFireandCustard
EB=EchoBurning|EmilyBeresford|ElizabethBear|EdoardoBallerini|ErikBear|ErnestBramah
EBE=EmeliaBEdwards
EBH=EmilyBurchHarris
EC=ElizabethCage|ExCommunication|EricConger|ElspethCooper|EoinColfer|EleanorCatton
ED=EmmaDonoghue
EDB=EDdeBirmingham
EE=ElizabethEdmondson|EdgeofEternity|EvilEye
EEB=ExecutedExtractedBook2|ExtinctExtractedBook3
EEG=EnchantersEndGame
EEPB=ExodusExtinctionPointBook2
EF=ExpeditionaryForce|EmiliaFox
EFB=EFBenson
EFM=ExpeditionaryForceMavericks
EG=EmmaGalvin|EmpireGames|ExtinctionGame|EnemyofGod|EmmaGregory|EndersGame
EGAE=EndersGame20thAnniversaryEdition
EH=ExHeroes|EchoesofHonor|ExoHunter
EJC=EmilyJaniceCard
EK=ElizabethKlett
ELB=EilidhLBeaton
ELSB=EmpireofLightShoalBook3
EM=EuanMorton|ErinMorgenstern|EdwinMiles
EMGJ=ElioMGarciaJr
EMJ=Ep10MoJoe
EMS=EricMichaelSummerer
EMVEMTF=ElricofMelnibonVolume1ElricofMelniboneTheFortressofthePearlTheSailorontheSeasofFateTheWeirdoftheWhiteWolf
EP=ExPatriots|ExtinctionPoint|EllPotter
EPEPB=ExtinctionPointExtinctionPointBook1
EPS=ExtinctionPointSeries
ER=EmilyRankin
ES=EvermenSaga|EndersShadow
ESB=EnchanterSpellmongerBook7
ET=EmmaThompson|EmperorofThorns
EU=EricUgland
EW=ElijahWood|EvelynWaugh|EdwinaWren
EWZ=EmilyWooZeller
F=Fellside|Firefight|Firstborn|Flashforward|Flood|Freedom|Flux|Free
FA=FoolsAssassin
FB=FrancesBarber|FernBritton
FBDHFB=FireflyBigDamnHeroFireflyBook1
FBHWJDS=FreeBobHoneyWhoJustDoStuff
FCTFSB=FireflyCarnivalTheFireflySeriesBook6
FD=FallenDragon|FeedingtheDragon|FinalDays|FieldofDishonor|ForgeofDarkness|ForgingDivinity
FDH=FallorDodgeinHell
FDHAN=FallorDodgeinHellANovel
FDV=ForgeofDarknessVolume2
FE=FeersumEndjinn|FlaginExile
FEFB=FalloutExpeditionaryForceBook13
FEFMB=FreefallExpeditionaryForceMavericksBook2
FETFTB=FoundationEmpireTheFoundationTrilogyBook2|FoundationandEmpireTheFoundationTrilogyBook2
FF=FaithoftheFallen|FalseFriends|FatalFrost|FablesFantasies|FoolsFate|FitzandtheFool|FrederickForsyth
FFMB=FightFlightMagic20Book4
FG=FairGame|FallofGiants
FGTFSB=FireflyGenerationsTheFireflySeriesBook4
FGTHHB=FalseGodsTheHorusHeresyBook2
FH=FrankHerbert|FionaHardingham
FK=FirsttoKill|ForcedtoKill
FL=FritzLeiber
FLSTFSB=FireflyLifeSignsTheFireflySeriesBook5
FM=FractalMode|FoolMoon|ForestMage
FMNTFSB=FireflyMagnificentNineTheFireflySeriesBook2
FMO=FoolMeOnce
FP=FaithfulPlace|FrankPeretti
FQ=FoolsQuest
FR=FirstResponse
FREE=FREE
FREEACC=FREEAChristmasCarol
FREEAIJ=FREEAudibleInterviewwithJodiTaylor|FREEAudibleInterviewwithJodiTaylorAuthorsintheStudio
FREEASJ=FREEAudibleSessionswithJeffreyArcher|FREEAudibleSessionswithJeffreyArcherExclusiveinterview
FREEDOW=FREEDOWNLOADJabberwocky|FREEDOWNLOAD
FREEOTW=FREEOnlyTimeWillTellCliftonChroniclesBook1
FREEPIA=FREEProfessionalIntegrityARiyriaChroniclesTale
FREETJA=FREETheJesterARiyriaChroniclesTale
FRTCSAE=FallofRadianceTheCompleteSeriesAnEpicFantasyBoxedSetBooks15
FSB=FootwizardSpellmongerBook13
FTFTB=FoundationTheFoundationTrilogyBook1
FTGMTFS=FireflyTheGhostMachineTheFireflySeriesBook3
FTHFBTM=FluxTalesofHumanFuturesBookTwoofMapsinaMirror
FTRFB=FarilaneTheRiseFallBook2
FTSLWM=FreeTheSecretLifeofWalterMitty
FW=FintyWilliams
FWAM=ForWeAreMany
FWMUMTF=FireflyWhatMakesUsMightyTheFireflySeriesBook7
G=Gatefather|Ghosts|Guilt
GA=GeoffAnnis|GarethArmstrong
GB=GregBear|GillianBurke|GeorgeBlagden
GBAOB=GlorytotheBraveAscendOnlineBook4
GC=GunnarCauthery|GabrielledeCuir|GenevieveCogman|GlenCook|GrantCartwright
GD=GardnerDozois
GDT=GuillermoDelToro
GE=GodsEye|GideonEmery
GEPSB=GenesisExtinctionPointSeriesBook4
GF=GillianFlynn
GFTHHB=GalaxyinFlamesTheHorusHeresyBook3
GG=GroverGardner|GaryGibson|GlennGers|GeorgeGuidall|GeorgeGoulding|GrainneGillis
GGBG=GoodGirlBadGirl
GGBGT=GoodGirlBadGirlTheyearsmostheartstoppingpsychologicalthriller
GH=GhostHunters|GreggHurwitz|GreggHurwtiz
GJ=GrahamJoyce
GL=GeorgeLamb
GM=GeorgiaMaguire|GrahamMasterton|GardensoftheMoon
GMN=GrahamMcNeill
GMTMBF=GardensoftheMoonTheMalazanBookoftheFallen1
GNR=GreatNorthRoad
GO=GreggOlsen|GeorgeOrwell|GavinOsborn|GoodOmens
GOB=GerryOBrien
GOTCBOM=GalaxyOutlawsTheCompleteBlackOceanMobiusMissions1165
GP=GravePeril|GregPatmore
GRRM=GeorgeRRMartin
GS=GerardSchwarz|GoldenSon|GalactogonSeries|GhostStory
GT=GaeanTrilogy|GoneTomorrow|GuillermodelToro|GhostlyTales
GTAACG=GhostlyTalesAnAudibleChristmasGift
GTYO=GrimmTalesforYoungOld|GrimmTalesforYoungandOld
GV=GabrielVaughan|GallowsView
GVTDCIB=GallowsViewThe1stDCIBanksMystery
GW=GuardiansoftheWest|GeorgeWilson|GeneWolfe|GemmaWhelan
H=Harbinger|Headhunters|Heartfire|Hellbent|Homebody|Hyperion|Homefront|Homeland
HAE=HonorAmongEnemies
HAEFADS=HomefrontAnExpeditionaryForceAudioDramaSpecial
HAS=HideAndSeek
HB=HollyBlack|HughBonneville|HiBob|HotBlood
HBCSMB=HopefortheBestChroniclesofStMarysBook10
HC=HarlanCoben
HCA=HansChristianAndersen
HD=HughDancy|HannahDaniel
HDDKTES=HowtoDefeataDemonKinginTenEasySteps
HDMT=HisDarkMaterialsTrilogy
HDTHDSB=HellDiversTheHellDiversSeriesBook1
HE=HarlanEllison
HF=HumanitysFire|HildaFay
HFTDCIR=HighForceTheDCIRyanMysteriesBook5
HG=HughGrant|HellsGate
HGW=HGWells
HGWTSFC=HGWellsTheScienceFictionCollection
HH=HughHowey|HarryHole|HartsHope|HonorHarrington
HHNF=HellHathNoFury
HITDCIR=HolyIslandTheDCIRyanMysteriesBook1
HJ=HelenJohns
HL=HughLee|HardLanding
HM=HarukiMurakami|HardMagic|HighMage
HMC=HowlsMovingCastle
HN=HeirofNovron
HND=HaveaNiceDay
HPAOB=HelltoPayAscendOnlineBook3
HPP=HomelandPhantomPain
HPS=HiddeninPlainSight
HR=HannuRajaniemi
HRBB=HeavensRiverBobiverseBook4
HRS=HerRoyalSpyness
HRTHHB=HorusRisingTheHorusHeresyBook1
HS=HelterSkelter
HSB=HedgewitchSpellmongerBook14
HSCB=HawkmaidenSpellmongerCadetBook1|HawkladySpellmongerCadetBook2
HT=HouseofTeeth|HomerTodiwala
HTDCIRM=HeavenfieldTheDCIRyanMysteriesBook3
HTPTALR=HeirTodayPawnTomorrowALitRPGGameLitNovelTheGoodGuysSeriesBook2
HTTTPB=HardTimeTheTimePoliceBook2
HW=HarrietWalter|HowardWaldrop
HWEW=HardboiledWonderlandtheEndoftheWorld|HardboiledWonderlandandtheEndoftheWorld
I=Inversions|Immoral|Influx|Innocence|Insurgent|Interface|It|Infinite|Infinite2
IA=IllegalAlien|IlonaAndrews|IsaacAsimov
IAAGTB=ImpostorAnAlexanderGregoryThrillerBook1
IAP=IAmPilgrim
IAPV=IAmPilgrimVolume1
IB=IainBanks
IC=IClaudius|IronCouncil
IEH=InEnemyHands
IF=IanFleming|IntotheFire
IFB=InFuryBorn
IGHB=IronGarlandHarbingerBook3
IH=IanHanmore
IHL=InaHouseofLies
II=IncarnationsofImmortality|IanIrvine
IMB=IainMBanks
IP=IanPorter|InvasiveProcedures
IR=IanRankin|InspectorRebus|IsabellaRose
ISDMSSB=InSessionDrMorganSnowwithSteveBerrysCottonMaloneLeeChildsJackReacherBarryEislersJohnRain
ISEGB=InvisibleSunEmpireGamesBook3
ISY=ISeeYou
IW=InterWorld|IntheWoods
IWS=IanWSainsbury
IYD=InYourDreams
J=Joyland|Juxtaposition|Journeymage
JA=JeffreyArcher|JoeAbercrombie|JaneAusten|JessicaAlmasy
JAA=JAAndrews
JAF=JamesAndersonFoster
JAS=JamesASullivan
JB=JoyceBean|JimBond|JustinBartha|JoeBarrett|JeremyBobb|JimButcher|JosephBrassey|JonathanBarlow
JBL=JohnBedfordLloyd
JC=JohnleCarr|JayneCastle|JodieComer|JeffCummings|JasonCulp|JohnCrowley|JohnChancer|JacquiCrago|JanCramer|JustinCronin|JohnleCarre
JD=JeanneDuprau|JonathanDavis|JefferyDeaver|JimDale|JotDavies
JDP=JeanneDuPrau
JE=JoyEllis|JayminEve|JamieEdmundson
JF=JonathanFranzen|JeffForshaw
JFG=JFrederickGeorge
JFR=JohnFranklynRobbins
JG=JackGarrett|JeffGurner
JGB=JGBallard
JH=JeffHarding|JamesHerbert|JamesHolland|JimHarrison|JamesHenry|JoshHurley|JackHawkins|JoeHill|JoanneHarris|JohnHough|JohnHarding|JacobHolo|JoeHarris|JillianeHoffman|JohnHodgman
JHR=JHRiddell
JI=JamesIslington
JJ=JoeJameson
JJA=JohnJosephAdams
JK=JonathanKellerman|JonathanKeeble|JohnKenneth|JeffreyKafer
JKR=JKRowling
JL=JohnLee|JamesLangton|JamesLovegrove|JosephLidster|JohnLescroart|JohnLeguizamo|JayLake|JamesLecesne|JennaLamia
JLV=JanuaryLaVoy
JM=JerryMerritt|JohnMilton|JimMeskimen|JamesMaxwell|JamesMacpherson|JonathanMaberry|JasonMatthews|JeffersonMays|JamesMarsters|JulianMay
JMB=JMBarrie
JMC=JohnMcCormack
JMM=JuanitaMcMahon
JMP=JamesMacPherson
JMT=JMaartenTroost
JN=JoNesbo
JO=JamesOswald|JonathanOliver
JODTAA=JustOneDamnedThingAfterAnother
JP=JodiPicoult|JerryPournelle|JoellePresby|JanciPatterson|JamesPatterson
JPT=JPTurner
JR=JayRubin|JonathanRenshaw|JackReacher|JustinaRobson|JohnRubinstein|JohnRingo|JeremyRobinson|JamesRedfield
JRRT=JRRTolkien
JRT=JulianRhindTutt
JS=JennySterlin|JohnScalzi|JaySnyder|JohnSessions|JoshuaSmith|JonathanStride|JerrySciarrio|JenniferSaunders
JSAC=JamesSACorey
JSM=JSMorin
JSMN=JonathanStrangeMrNorrell
JT=JodiTaylor|JulieTeal|JamesThurber
JTW=JTWilliams
JU=JudasUnchained
JV=JohnVarley|JenniferVuletic|JohnVerdon
JW=JoWalton|JoeWicks|JeffWheeler|JeffWoodman|JannyWurts|JenniferWiltsie|JuliaWhelan
JWB=JeevestheWeddingBells|JeevesandtheWeddingBells
JY=JonathanYen|JamesYaegashi
K=84K|Killer
KA=KristinAtherton|KaneAbel|KareemAbdul|KaneandAbel
KC=KarlaCrome|KillingCommendatore|KnotsCrosses|KnotsandCrosses
KCJMB=KillaCityJohnMiltonBook17
KD=KillDecision|KnifeofDreams|KateDaniels|KrisDyer
KE=KateElliott
KF=KenFollett|KevinFoley
KG=KennethGrahame
KH=KhristineHvam|KristinHvam|KirbyHeyborne
KHHB=KnifeHarryHoleBook12
KHS=KobnaHoldbrookSmith
KI=KazuoIshiguro
KJA=KevinJAnderson
KJP=KJParker
KK=KatherineKellgren|KevinKraft
KL=KirstyLogan
KM=KatheMazur|KingoftheMurgos|KateMosse|KnightsMagi|KateMulgrew|KateMorton
KMADCIT=KillMeAgainDCITomDouglasBook5
KN=KimNewman
KP=KarenPeakes|KevinPariseau|KarlPrekopp
KR=KateReading|KarenRose|KateRawson|KateRudd|KeepingitReal|KatRosenfield
KRTFAB=KnightsRansomTheFirstArgentinesBook1
KS=KarinSalvalaggio|KateScarfe|KafkaontheShore|KarlSchroeder
KT=KharkanasTrilogy|KingofThorns|KristofferTabori
KV=KingoftheVagabonds
L=Labyrinth|Lastnight|Lost|Lullaby|Luther|Lux
LA=LauraAikman|LindaAntonsson
LATRN=LuxATexasReckonersNovel
LB=LeighBardugo|LetitBleed|LaurenceBouvard|LittleBig|LostBoys
LBSTBDV=LaBelleSauvageTheBookofDustVolumeOne
LC=LeeChild|LewisCarroll|LukeChmilenko|LisaColeman|LarryCorreia|LordofChaos
LCC=LisaCaruccioCame
LD=LukeDaniels|LegionoftheDamned|LittleDonkey
LDLH=LiesDamnedLiesHistory
LDP=LouDiamondPhillips
LE=LindaEvans
LF=LaundryFiles|LiveFire|LondonFalling|LostFound|LucyFoley|LostandFound
LFAOB=LegacyoftheFallenAscendOnlineBook2
LG=LaurenGunderson|LindaGreen|LevGrossman
LH=LucifersHammer|LeslieHoward|LucindaHawksley
LHM=LatinHistoryforMorons
LJ=LloydJames
LJG=LJGanser
LJR=LJRoss
LK=LoreleiKing
LKH=LaurellKHamilton
LL=LukeLieberman|LadyoftheLake
LLP=LyndaLaPlante
LLPS=LifeLibertythePursuitofSausages|LifeLibertyandthePursuitofSausages
LMMB=LoisMcMasterBujold
LMS=LeeMaxwellSimpson
LN=LarryNiven
LNW=LeahNanakoWinkler
LP=LifeofPi
LPC=LostonPlanetChina
LPL=LucyPriceLewis
LR=LockedRooms
LRK=LaurieRKing
LRTFAB=LadysRansomTheFirstArgentinesBook3
LS=LukeSmitherd|LawrenceSanders|LewisShiner
LSECB=LongShadowsElizabethCageBook3
LSTHSBF=LostSongsTheHiddenStoriesBookFiveofMapsinaMirror
LT=LainiTaylor
LTDCIRM=LongstoneTheDCIRyanMysteriesBook10
LTTSST=LightTouchThe14thSpiderShepherdThriller
LW=LastoftheWilds|LooktoWindward|LethalWhite|LizWilliams|LeviathanWakes
LY=LouisaYoung
M=Magic20|Malloreon|Mavericks|Magician|Magyk|Matter|Midnight|Mindscan|Mirrorworld|Moriarty|Morte|Multiverse|Mythos|Magelord|Mistborn|Mithermages
MA=MattAddis|MeganAbbott
MAL=MALarkin
MB=MichaelBrooks|MarkBoyett|MiaBarron|MindBullet|MaxBeesley|MitchBenn|MarkBramhall
MC=MortalCauses|MichaelCobley|MaxwellCaulfield|MichaelCrichton
MCB=MCBeaton
MD=MarkDawson|MarkDeakins
MDIWTYB=MyDearIWantedtoTellYouBookDPodcastBook20
MDSBT=MultitudeDimensionSpaceBookTwo
MEB=MaryElizabethBraddon
META=METAtropolis
MF=MoFarah|MichalFriedman|MadnessoftheFallen
MFS=MichaelFentonStevens
MG=MichaelGoldstrom|MelodyGrove|MagiciansGambit|MarkGreaney|MargueriteGavin
MGEFB=MatchGameExpeditionaryForceBook14
MGTHSB=MirrorGateTheHarbingerSeriesBook2
MH=MelHudson|MalcolmHillgartner|MichaelHogan|MycroftHolmes
MHI=MonsterHunterInternational
MJ=MichaelJayston
MJA=MJArlidge
MJAWMTD=MoJoeAn18WeekMarathonTrainingDiary
MJR=MJRose
MJS=MichaelJSullivan
MK=MichaelKramer|MichaelKelly|MichioKaku
MKE=MKEngland
ML=MaryLamb|MarkLawrence|MeganLindholm
MLA=MacLeodAndrews
MM=MaggieMash|MagpieMurders|MakeMe|MemoryMan|MrMercedes|MysteryMan|MichaelMoorcock|MarkMeadows|MichaelMaloney
MMFFBTM=MapsinaMirrorFablesandFantasiesBookThreeofMapsinaMirror
MN=MikaelNaramore
MP=MichaelPage|MansfieldPark|MichaelPalmer
MR=MichaelRobotham|MartynRead|MichaelReaves|MindstarRising|MartyRoss|MarioReading
MRC=MRCarey
MRJ=MRJames|MontagueRhodesJames
MRJRNAC=MRJamesRatsfromtheNaxosAudiobookClassicGhostStories
MRJTMNC=MRJamesTheMezzotintNaxosClassicGhostStories
MRTRFDO=MasteroftheRevelsTheRiseFallofDODOBook2
MS=MelindaSnodgrass|MadhuriShekar|ModeSeries|MagicStrikes|MarchtotheSea|MarchtotheStars|MarkSherman|MorningStar|MichaelScott|MichaelSheen|MillenniumSeries
MT=MarkTwain|MarkTeppo
MTS=MightierThantheSword
MU=MarchUpcountry
MV=MarcVietor
MW=MargaretWeis|MarkWinston
N=Nightside|Nemesis|Nightfall|Nightmare|Nightshade
NA=NorthangerAbbey|NigelAnthony|NealAsher
NB=NicolaBarber|NewBeginnings
NC=NickChoksi|NigelCarrington|NewCrobuzon|NeilCross|NaturalCauses|NowhereChild
NCADCIT=NowhereChildADCITomDouglasNovella
ND=NeilDixon|NightsDawn
NE=NakedEmpire
NG=NeilGaiman|NicoleGalland
NH=NeilHellegers
NL=NorthernLights|NightingalesLament
NLB=NeverLookBack
NLMDAJM=NeverLetMeDownAgainJohnMiltonBook19
NMB=NathanMcBride
NME=NataschaMcElhone
NO=NotOne
NP=NickPodehl
NPC=NPCs|NPC
NPMNPL=NotaPennyMoreNotaPennyLess
NR=NelsonRunger|NatalieRoss|NapoleonRyan
NS=NealStephenson|NightSchool|NickSullivan
NSB=NecromancerSpellmongerBook10
NSS=NicholasSansburySmith
NT=NevadaTan|NickTaylor
NTLP=NoTimeLikethePast
NTRFB=NolynTheRiseFallBook1
NV=NothingVentured
NW=NorwegianWood|NovaWar
NWS=NightWithoutStars
NYN=NewYorkNight
O=Odalisque|Outlander|Oathbringer|Outland
OB=OliverBowden
OBS=OnBasiliskStation
OBW=OfftoBetheWizard
OC=OliviaColman
ODOXB=OutoftheDarkOrphanXBook4
OEND=OurEndlessNumberedDays
OGE=OfGodsandElves
OHMSSI=OnHerMajestysSecretServicewithInterview
OI=OnlytheInnocent
OJ=OJerusalem
OK=OptiontoKill
OMDB=OverMyDeadBody
OMDBWWN=OverMyDeadBodyWilliamWarwickNovels
OMLTALR=OneMoreLastTimeALitRPGGameLitNovelTheGoodGuysBook1
OMM=OutofMyMind
OP=OutofPhaze
OPH=OnaPaleHorse
OS=OathofSwords
OSC=OrsonScottCard
OSOMMB=OutofSpiteOutofMindMagic20Book5
OSTAAB=OntheShouldersofTitansArcaneAscensionBook2
OT=OnTarget|OddThomas|OwnerTrilogy|OversightTrilogy
OTWTCCB=OnlyTimeWillTellCliftonChroniclesBook1
OUTN=OnceUponaTimeintheNorth
OW=OliverWyman
OWICYML=OhWhistleIllCometoYouMyLad|OhWhistleandIllCometoYouMyLad
OX=OrphanX
P=Paradise|Postmortem|Passage|Passenger23|Pastwatch|Pathfinder|Personal|Petrified|Phantom|Phantoms|Police|Protector|Poisonwell
PA=PiersAnthony|PrenticeAlvin
PAAOD=Passenger23AnAudibleOriginalDrama
PAJ=PaulAntonyJones
PB=PaulBoehmer|PierceBrown|PeterBrooke|PileofBones|PaoloBacigalupi
PC=PeterClines|PatriciaCornwell|PaulCornell|PatCadigan
PCHB=PrismCloudHarbingerBook4
PCPG=PCPeterGrant
PCTPSTB=PhantomChainfireTrilogyPart2SwordofTruthBook10
PD=PhazeDoubt|PrivateDancer
PDBETWT=PathofDaggersBookEightofTheWheelofTime
PDCIRB=PenshawDCIRyanBook13
PED=PenryntheEndofDays
PF=PrinceofFools|PeterForbes
PFH=PeterFHamilton
PG=PhilipGabriel|PeterGanim|PhilipGlenister
PGW=PGWodehouse
PGWV=PGWodehouseVolume1
PGWVTJC=PGWodehouseVolume1TheJeevesCollection
PH=PaulHoffman|PaulaHawkins
PHM=ProjectHailMary
PJ=PeterJoyce
PK=PeterKenny|PenelopeKeith
PL=PeterLarkin|PlaytoLive|ProofofLove|PatrickLawlor
PLBD=PhyllidaLawBookD2
PLBDMCB=PhyllidaLawBookD23MothersaCamelBookDPodcast
PM=PeterMay
PMD=PennyMcDonald
PMG=PaulMichaelGarcia
PN=PeterNoble
PP=PappyPariah|PhilipPullman|PawnofProphecy|PeterPan
PPAAOD=PeterPanAnAudibleOriginalDrama
PPZ=PridePrejudiceZombies|PrideandPrejudiceandZombies
PR=PeterRobinson|PatrickRothfuss
PRS=PrinceRogerSeries
PS=PaulSparks|PaladinofSouls|PandorasStar|PrimeSuspect|PathfinderSeries
PSPSB=PrimeSuspectPrimeSuspectBook1
PSS=PerdidoStreetStation
PT=PaulThornley|PalaceofTreason|PastTense|PrinceofThorns
PTBE=PrinceofThornsBrokenEmpire1
PTTDFB=PeaceTalksTheDresdenFilesBook16
PV=PaulaVolsky
PVB=PeterVBrett
PW=PriestessoftheWhite|PeterWickham|ParallelWorlds
PWAJTCH=ParallelWorldsAJourneyThroughCreationHigherDimensionsandtheFutureoftheCosmos
PWCSMB=PlanfortheWorstChroniclesofStMarysBook11
Q=1Q84|Quicksilver
QF=QueenofFire
QG=QuantumGravity
QGTQEB=QuantumGardenTheQuantumEvolutionBook2
QP=QuintonPeeples
QS=QueenofSorcery
R=Revelations|Radio|Reamde|Rebecca|Reflex|Resonance|Revival|Roadkill|Rogues|Room|Rotherweird|Reckoners
RA=RogerAllam|RachelAbbott|RachelAtkins|RichardArmitage|RobotAdept|RoyalAssassin|RichardAdams|RichardAspel|RizAhmed
RB=RobertoBolao|RhysBowen|RayBradbury|RichardBrewer
RBYDCIT=RightBehindYouDCITomDouglasBook9
RC=RobertCrais
RCADCIR=RyansChristmasADCIRyanMysteryTheDCIRyanMysteriesBook15
RCB=RCBray
RCC=RyanCalaisCameron
RCW=RobertCharlesWilson
RD=RoyDotrice|RupertDegas|RichardDawkins|RodDuncan
RDC=RDCarstairs
RDSFB=ReDawnSkywardFlightBook2
RDW=RDWingfield
RE=RainbowsEnd|RiseofEmpire|RaulEsparza
REF=RaymondEFeist
REFB=RenegadesExpeditionaryForceBook7
REG=RichardEGrant
RF=RichardFerrone
RG=RobertGalbraith|RobertGlenister|RobertGraves
RGTCCB=RobotGeneticistsTheCompleteCollectionBooks16
RH=RomanHoliday|RobinHobb
RI=RobInglis
RJ=RobertJordan|RoughJustice|RicJerrrom|RazaJaffrey
RJMB=RoninJohnMiltonBook18|RedeemerJohnMiltonBook12
RJS=RobertJSawyer
RK=ReadytoKill|RudyardKipling
RKTJB=RudyardKiplingsTheJungleBook
RL=RayLonnen|RiversofLondon|RobertLittell|RalphLister
RLS=RobertLouisStevenson
RM=RichardMorgan|RobinMorgan|RobertMasello|RenegadesMagic
RML=RonMcLarty
RMTCTRM=RoguesofMagicTheCompleteTrilogyRoguesofMagicBooks13
RP=RayPorter|RedProphet|RonPerlman
RPB=RuinsPathfinderBook2
RPJ=RupertPenryJones
RQW=RedQueensWar
RR=RobertRankin|RichardRohan|ReneRaudman|RobertRepino|RedRising|RiyriaRevelations|RobReid
RRB=RotherweirdRotherweirdBook1
RRH=RRHaywood
RS=RaySawyer|RavensShadow|RedSparrow|RevelationSpace|RyanSilbert
RST=RedSparrowTrilogy
RT=RachelTrezise
RW=RogerWayne
RWC=RobertWChambers
RWTSAB=RhythmofWarTheStormlightArchiveBook4
RZ=RogerZelazny
S=Sweetpea|Shoal|Saints|Salvation|Scoop|Scorpion|Serpentine|Seveneves|Shadowmarch|Shadowplay|Shadowrise|Shadowheart|Shatter|Shift|Silverthorn|Skyward|Songmaster|Spellbound|Spellmonger|Starfire|Starsight|Steelheart|Sten|Stories|Stormwarden|Sundiver|Sunstorm|Suspect|Shannara
SA=StephenArmstrong|SophieAldred|SupernaturalAcademy
SACC=SinsofAngelsCompleteCollection
SACCB=SinsofAngelsCompleteCollectionBooks15
SAD=SwordsAgainstDeath
SADTAFG=SwordsAgainstDeathTheAdventuresofFafhrdtheGrayMouser
SAG=SandmanAudioGraphic
SAM=SufficientlyAdvancedMagic
SAYO=SupernaturalAcademyYearOne
SB=SeanBaker|StephenBaxter|SeanBarrett|StevenBrand|ScottBrick|StephenBriggs|StevenBoyer|SaskiaButler|SenBarrett|StevenBarnes|SimonBruni
SBD=StephenBelDavies
SBTDCIR=SevenBridgesTheDCIRyanMysteriesBook8
SBTSST=SlowBurnThe17thSpiderShepherdThriller
SC=SimonCallow|StrangerChild|SusannaClarke|StephenCritchlow|SimonCadell|SteveCavanagh|SixofCrows|SnowCrash|SpellmongerCadet|StevenCrossley|SuzanneCollins|ShamansCrossing
SCT=SnakeheadChinaThriller4
SD=SarahDouglas|SaintDeath|ShipofDestiny|SorceressofDarshiva|SpeakerfortheDead|StrangetheDreamer|SurfaceDetail|SarahDurham|SwordofDestiny|SwordsandDeviltry
SDA=SixDegreesofAssassination
SDAAAD=SixDegreesofAssassinationAnAudibleDrama
SDBGSB=SeastheDayBadGuysSeriesBook5
SDE=SongsoftheDyingEarth
SDJ=SirDerekJacobi
SDSBO=SolitudeDimensionSpaceBookOne
SDTAFGM=SwordsDeviltryTheAdventuresofFafhrdtheGrayMouser
SE=SusanEe|StevenErikson|SeedsofEarth|SideEffects|SongsoftheEarth
SF=SebastianFitzek|SebastianFaulks|StephenFry|ShadowsinFlight|SkywardFlight|SouloftheFire|StormFront
SFN=SanFranciscoNight
SFTFTB=SecondFoundationTheFoundationTrilogyBook3
SG=SolomonsGold|SethGrahame|StevenGould|SleepingGiants|StarttheGame|SkinGame|SaraGruen
SGHB=StormGlassHarbingerBook1
SGTDCIR=SycamoreGapTheDCIRyanMysteriesBook2
SH=SeanHayes|StephenHogan|SusannahHarker|StaceyHalls|SeptimusHeap|ShadowoftheHegemon
SHW=SpellorHighWater
SI=SplitInfinity
SJ=SuzyJackson|SusieJames|StripJack|SideJobs
SJMB=SleepersJohnMiltonBook13
SJSDF=SideJobsStoriesfromtheDresdenFiles
SK=StephenKing|SummerKnight
SKFT=SomeKindofFairyTale
SKS=StephanieKSmith
SL=StephenLeather|SalvationLost|StanLee|StealingLight|ScottLynch|StiegLarsson
SLA=StanLeesAlliances
SLAATL=StanLeesAlliancesATrickofLight
SM=ScottMeyer|ShvorneMarks|SimonMawer
SMB=StevenMichaelBohls
SMC=SorchaMcCaffrey
SMH=SteveMcHugh
SMTLTB=ShipofMagicTheLiveshipTradersBook1
SN=SylvainNeuvel|SomethingfromtheNightside
SO=SpecOps|SeanOhlendorf|SaintOdd
SP=StevenPacey|SeanPenn|SimonPrebble|SarahPainter|ShadowPuppets|SuePitkin
SQ=SurvivalQuest
SR=StefanRudnicki|SeanRunnette|SakinasRestaurant|SalvationRow|ShamansRevenge|SaulReichlin|SamuelRoukin
SRG=SimonRGreen
SRSCB=SkyRiderSpellmongerCadetBook3
SRTSST=ShortRangeThe16thSpiderShepherdThriller
SS=SingularSet|SemanaSanta|SeventhSon|ShadowsofSelf|SilentScream|SputnikSweetheart|SamanthaShannon|SimonSlater|SofiaSegovia|StealingSorcery|SeasonofStorms|SpiderShepherd
SSB=ShadowmageSpellmongerBook9
SSBGB=ScampsScoundrelsBadGuysBook1
SSFB=SunreachSkywardFlightBook1
SSLSB=ShadowplaySpellmongerLegacySecretsBook1|ShadowplaySpellmongerLegacyandSecretsBook1
SSMBGSB=SecondStoryManBadGuysSeriesBook2
SSSAS=SpiderShepherdSAS
SSSWWB=SixSacredSwordsWeaponsWieldersBook1
SSVII=ShadowplayShadowmarchVolumeII
SSVIII=ShadowriseShadowmarchVolumeIII
SSVIV=ShadowheartShadowmarchVolumeIV
SSWR=ShipsStingsWeddingRings|ShipsandStingsandWeddingRings
ST=StephenThorne|SwordofTruth|SamTsoutsouvas|ScarlettThomas|SoftTarget|StoneofTears|SavingTime
STATPN=SavingTimeATimePoliceNovel
STBGSB=SkullThronesBadGuysSeriesBook3
STDCITD=SleepTightDCITomDouglasBook3
SV=SimonVance
SVPSB=SilentVictimsPrimeSuspectBook3
SW=SharonWashington|SamuelWest|StevenWeber|ShadowoftheWolf|SteveWhite|SteelWorld|SteveWest
SWDWCTS=SixteenWaystoDefendaWalledCityTheSiegeBook1
SWTP=ShallWeTellthePresident
SWTWCAS=SomethingWickedThisWayComesASoundofThunder
SYET=ShutYourEyesTight
SYS=SayYoureSorry
T=Tribe|Terra|Threadneedle|Timeline|Touch|Touchstone|Transcendent|Transition|Treason|Tarantula
TA=TheAlchemyst|TheAlgebraist|TheAssassin
TAA=TheAtrocityArchives
TAAIRTB=TheAngelAnIsabellaRoseThrillerBook1|TheAssetAnIsabellaRoseThrillerBook2
TABC=TheAdventureoftheBlueCarbuncle
TABD=TheAbyssBeyondDreams
TABLP=TheAbsoluteBrightnessofLeonardPelkey
TACTLFB=TheApocalypseCodexTheLaundryFilesBook4
TAFT=TheAncientFutureTrilogy
TAG=TheAtlantisGene
TAIRB=TheAgentIsabellaRoseBook3
TAJMB=TheAlamoJohnMiltonBook11
TAJMSS=TarantulaAJohnMiltonShortStory
TAL=TheAlloyofLaw
TAM=TalesofAlvinMaker|TheAccidentMan|TheAmbassadorsMission
TAP=TheAtlantisPlague
TAS=TheAmberSpyglass|TheAnnihilationScore
TAT=TheAshTree
TATSIIA=TheAdventuresofTomStrangerInterdimensionalInsuranceAgent
TAW=TheAeronautsWindlass|TheAtlantisWorld
TB=TonyBallantyne|TraberBurns|TomBateman|TobiasBuckell|TheBelgariad|TheBat|TheBeginning|TomBale|TerryBrooks|ToddBoyce|TreasureBox
TBA=TheBeekeepersApprentice
TBB=TheBlackBook
TBCSB=TroubledBloodCormoranStrikeBook5
TBD=TheBookofDust
TBE=TheBrokenEmpire
TBEWWB=TurnaBlindEyeWilliamWarwickBook3
TBG=TheBuriedGiant
TBHW=TheBeatingofHisWings
TBI=TheBladeItself
TBITFLB=TheBladeItselfTheFirstLawBookOne
TBKTRTB=TheBookofKoliTheRampartTrilogyBook1
TBM=TheBookofMagic
TBMACSV=TheBookofMagicACollectionofStoriesbyVariousAuthors
TBMT=TheBlackMagicianTrilogy
TBNS=TheBookoftheNewSun
TBP=TheBonesofParis
TBR=TheBackRoad
TBS=TheBoneSeason
TBT=TheBTeam
TBW=TheBlindWatchmaker
TC=TrudiCanavan|TheConfusion|TomCain|TheChild|TheChimes|TheCleaner|TheCobweb|TheCollectors|TheCompany|TheCore|ThrillersCrime|TimeofContempt|TrueColours|TwinbornChronicles
TCA=TheCitadeloftheAutarch
TCAAD=TheChildAnAudibleDrama
TCAC=TwinbornChroniclesAwakeningCollection
TCBOMM=TheCompleteBlackOceanMobiusMissions
TCC=TheCliftonChronicles|TheCompleteCollection|TheClawoftheConciliator|TheCuckoosCalling|TheCurseofChalion|TheCuckoosCry
TCCAAON=TheCuckoosCryAnAudibleOriginalNovella
TCDATSB=TheCaptainsDaughterArkshipTrilogySeriesBook2
TCE=TheCityofEmber
TCEF=TheCityontheEdgeofForever
TCETFBE=TheCityofEmberTheFirstBookofEmber
TCH=TheChristmasHirelings
TCHACG=TheChristmasHirelingsAudibleChristmasGift2018
TCM=TheCityofMirrors
TCOWB=TheChosenOnesWorldquakeBook2
TCP=TheCelestineProphecy
TCPTFAB=TheCruelPrinceTheFolkoftheAirBook1
TCS=TheCodeSeries|TheCincinnatiSeries|TheCinderSpires|TheChildrenoftheSky
TCSM=TheChroniclesofStMarys|TheChroniclesofStMary
TCSS=TheCompleteShortStories
TCSSH=TheCompleteStoriesofSherlockHolmes
TCT=TheCrownTower|TheChinaThrillers
TCWW=TwinbornChroniclesWarof3Worlds
TD=TheDark|TheDeparture|TheDispatcher|TheDriver
TDA=TheDarkAge|TheDiamondAge
TDB=TheDeliriumBrief|TheDarkwaterBride
TDBAAOD=TheDarkwaterBrideAnAudibleOriginalDrama
TDC=TheDemonCycle
TDCIRM=TheDCIRyanMysteries
TDD=TheDeathofDulgath|TheDiamondofDarkhold
TDDTFBE=TheDiamondofDarkholdTheFourthBookofEmber
TDF=TheDresdenFiles
TDHG=TheDiaryofaHounslowGirl
TDHGAAO=TheDiaryofaHounslowGirlAnAudibleOriginal
TDJMB=TwelveDaysJohnMiltonBook14
TDM=TheDraconisMemoria
TDMP=TheDiaryofMrPoynter
TDR=TheDragonReborn
TDS=TheDesertSpear|TheDevilsStar
TDV=TheDreamingVoid
TDW=TheDaylightWar
TDWD=TheDisappearanceofWintersDaughter
TE=TheExpanse|TheEyewitness|TimesEye
TEA=TheEmpireofAshes
TEB=TheEmperorsBlades
TED=TheEndoftheDay
TEDTCSB=TheElforDropTheCodeSeriesBook2
TEFF=TheatreattheEdinburghFestivalFringe2019
TEM=TheEveningtheMorning|TheEveningandtheMorning
TEMTSMB=TheEmptyMenTheStoneManBook2
TEP=TheEinsteinProphecy
TES=TheEvermenSaga
TETSEB=TheElvenTheSagaoftheElvenBook1
TEV=TheEvolutionaryVoid|TheElephantVanishes
TEVS=TheElephantVanishesStories
TEW=TheEyeoftheWorld
TF=TanaFrench|TheFoundling|TheFall|TheFireman|ThemisFiles
TFA=TheFolkoftheAir|TheFallenAngel|TheFirstArgentines
TFDS=TheFirstDeadlySin
TFE=TheFinalEmpire
TFF=TheFolkoftheFringe|TheFourthFriend
TFFAJET=TheFourthFriendAJackmanEvansThriller
TFFLHA=TheFirstFifteenLivesofHarryAugust
TFFS=TheFlyingFlamingoSisters|TheFrogmortonFarmSeries
TFG=TheFistofGod|TheForgottenGarden
TFGLE=TheFalloftheGasLitEmpire
TFH=TheFiresofHeaven
TFK=TheFarKingdoms
TFM=TheForeverMan
TFMTLFB=TheFullerMemorandumTheLaundryFilesBook3
TFS=TheForeworldSaga
TFSTCTB=TheFourthSacrificeTheChinaThrillersBook2
TFT=TheFarseerTrilogy|TheFamilyTrade|TheFoundationTrilogy
TFTCTB=TheFiremakerTheChinaThrillersBook1
TFW=TheForeverWatch
TG=TerryGoodkind|TheGameshouse
TGAG=TheGirlwithAlltheGifts
TGB=TheGraveyardBook
TGBS=TheGoodtheBadtheSmug|TheGoodtheBadandtheSmug
TGC=TheGodlingChronicles
TGCATSB=TheGodlingChroniclesATrialofSoulsBook4
TGCOGE=TheGodlingChroniclesOfGodsElves
TGCTSGB=TheGodlingChroniclesTheShadowofGodsBook3
TGCTST=TheGodlingChroniclesTheSwordofTruth
TGD=TheGodDelusion
TGDT=TheGirlwiththeDragonTattoo
TGE=TheGardenofEvil
TGF=TheGoldenFool
TGH=TheGodoftheHive|TheGreatHunt
TGK=TheGraveKingdom
TGM=TheGlassMagician|TheGrayMan
TGMT=TheGregMandelTrilogy
TGO=TheGuiltyOnes
TGOAJET=TheGuiltyOnesAJackmanEvansThriller
TGP=TheGordianProtocol
TGPTGPB=TheGordianProtocolTheGordianProtocolBook1
TGR=TimGerardReynolds
TGS=TheGatheringStorm
TGSE=TheGreatestShowonEarth
TGSMDO=TheGreatStMarysDayOut
TGSW=TheGirlintheSpidersWeb
TGT=TheGateThief|TheGirlontheTrain
TGTB=TitanGaeanTrilogyBook1
TGTSTTT=TheGameshouseTheSerpentTheThiefTheMaster
TGWCR=TheGirlWhoCouldntRead
TGWDT=TheGirlWiththeDragonTattoo
TGWFS=TheGirlWhoFellfromtheSky
TGWKHN=TheGirlWhoKickedtheHornetsNest
TGWLT=TheGirlWhoLivedTwice
TGWLTAN=TheGirlWhoLivedTwiceANewDragonTattooStory
TGWPF=TheGirlWhoPlayedwithFire
TGWTEE=TheGirlWhoTakesanEyeforanEye
TH=TamiHoag|TomHolt|TracyHickman|TerryHayes|TimHall|TraciHarding|TheHobbit|TheHunter
THA=TheHeroofAges
THC=TheHellequinChronicles
THD=TheHumanDivision|TheHouseofDolls
THDS=TheHellDiversSeries
THG=TheHungerGames
THH=TheHallowedHunt|TheHorusHeresy
THL=TheHighLord
THLMC=TheHalfLifeofMarieCurie
THM=TheHangedMan
THMTDBO=TheHangedManTalesofDreadBookOneofMapsinaMirror
THP=TheHuntingParty
THQ=TheHonoroftheQueen
THR=TheHangmansRevolution|TheHiddenRelic
THS=TheHarbingerSeries|TheHouseofSilk|TheHydrogenSonata
THTDCIR=TheHermitageTheDCIRyanMysteriesBook9
THWAPB=TheHouseintheWoodsAtticusPriestBook1
TI=TheInfirmary|TheInheritance|TheIckabog|TreasureIsland
TIAAOD=TreasureIslandAnAudibleOriginalDrama
TIADCIR=TheInfirmaryADCIRyanMysteryMulticastDramaAnAudibleOriginalDrama
TIASH=TheImprobableAdventuresofSherlockHolmes
TIBS=TheInspectorBanksSeries
TIF=TheImmortalityFactor
TIL=TheInvisibleLibrary
TILTILB=TheInvisibleLibraryTheInvisibleLibraryBook1
TISHM=ThisIstheStoryofaHappyMarriage
TJ=TheJester|TheJungle
TJD=TheJewelofDantenos
TJDTFRE=TheJewelofDantenosTheFREELeeStarfinderAdventurefromtheWorldoftheGodlingChroniclesBook05
TJM=TheJenniferMorgue
TJQ=TheJunkieQuatrain
TJR=TheJekyllRevelation
TK=TheKilling
TKC=TheKingkillerChronicle
TKCRSTB=TheKremlinsCandidateRedSparrowTrilogyBook3
TKCS=TheKarmadontChessSet
TKCTCTT=TheKeeperChroniclesTheCompleteTrilogyTheKeeperChroniclesBook13
TKFTGKB=TheKillingFogTheGraveKingdomBook1
TKG=TheKartossGambit
TKN=TheKingsbridgeNovels
TKRTCTB=TheKillingRoomTheChinaThrillersBook3
TKY=TheKinginYellow
TL=TobyLongworth|TimLebbon|TanithLee|TheLeopard|TheLikeness|TheLuminaries|TowerLord
TLATFTL=TheLightofAllThatFallsTheLicaniusTrilogyBook3
TLC=TheLongCosmos
TLD=TheirLostDaughters
TLDA=TheirLostDaughtersAudiblesbreakthroughcrimeauthorof2018
TLE=TheLongEarth|TheLoreoftheEvermen
TLF=TheLaundryFiles|TheLegionofFlame
TLFE=TheLegendsoftheFirstEmpire
TLFT=TheLastFourThings
TLG=TheLostGate
TLHCE=TheLastHunterCollectedEdition
TLHG=TheLeftHandofGod
TLILFB=TheLabyrinthIndexLaundryFilesBook9
TLK=TheLiarsKey
TLLL=TheLiesofLockeLamora
TLM=TheLongMars
TLMB=TheLastMortalBond
TLS=TheLastShip
TLT=TheLicaniusTrilogy|TheLiveshipTraders
TLTSTM=TheLastThingSheToldMe
TLU=TheLongUtopia
TLW=TheLongWar|TheLastWish
TM=TerryMancour|TheMithermages|TheMartian|TheMongoliad|TheMalloreon|TowersofMidnight|TwistedMetal
TMB=TheMagiciansBook1|TheMurderBag|TheMurmurofBees
TMC=TheMerlinConspiracy
TMCL=TheManyColoredLand
TMDC=TheManfromtheDiogenesClub
TMDCIRB=TheMoorDCIRyanBook12
TMG=TheMagiciansGuild
TMGE=TheMoteinGodsEye
TMKB=TheMagicianKingBook2
TML=ToddMcLaren|TheMidnightLine
TMLB=TheMagiciansLandBook3
TMMG=TheMoonMazeGame
TMS=TheMadShip|TheMurderersSon
TMSAJET=TheMurderersSonAJackmanEvansThriller
TMSSB=TheManagementStyleoftheSupremeBeings
TMT=TawnyManTrilogy
TMV=TheMurderattheVicarage
TMW=TheMaidsWar
TMWNWJM=TheManWhoNeverWasJohnMiltonBook16
TN=TheNovice|ThinkofaNumber|ToothNail|ToothandNail
TNA=TheNeutroniumAlchemist
TNAPAN=TheNiceandAccuratePropheciesofAgnesNutter
TNC=TheNightCircus
TNE=TheNightEternal
TNF=TheNanoFlower
TNG=TheNakedGod
TNGTFFS=TheNothingGirlTheFrogmortonFarmSeriesBook1
TNL=TellNoLies
TNM=TheNowhereMan
TNP=TheNostrodamousProphecies|TheNostradamusProphecies
TNRCIB=TheNightRavenCrowInvestigationsBook1
TNS=TheNightmareStacks|TheNinthStep
TNW=TheNameoftheWind
TO=TheOthers|TheOrder|TimeOdyssey|TheOath|TheOversight
TOA=TheOutsorcerersApprentice
TOEL=TheOceanattheEndoftheLane
TOM=TheOriginMystery|TheOmenMachine
TOTSST=TallOrderThe15thSpiderShepherdThriller
TP=TheresePlummer|TimPowers|TroubleonParadise|TerryPratchett|TonyParsons|TheParadox|ThePassage|ThePrestige|TimePolice
TPBW=ThePathsBetweenWorlds
TPC=ThePhantomCastle|ThePillarsofCreation
TPD=ThePortableDoor|TheProdigalDaughter
TPE=ThePillarsoftheEarth
TPEAKPB=ThePoisonersEnemyAKingfountainPrequelBook025
TPF=TheProvidenceofFire
TPG=ThePlayerofGames
TPM=ThePaintedMan
TPS=ThePathoftheStorm|ThePenroseSeries|ThePeopleofSparks
TPSTSBE=ThePeopleofSparksTheSecondBookofEmber
TPT=ThePassageTrilogy
TPWA=ThePursuitofWilliamAbbey
TPY=TheProphetofYonwood
TPYTTBE=TheProphetofYonwoodTheThirdBookofEmber
TQ=TheQuest
TQE=TheQuantumEvolution
TQM=TheQuantumMagician
TQT=TheQuantumThief
TQWTQEB=TheQuantumWarTheQuantumEvolutionBook3
TR=TheRedbreast|TheRedeemer|TheRemnant|TheRithmatist|TheRogue
TRC=TheRiyriaChronicles|TheRhesusChart
TRD=TheRealityDysfunction|TheRemainsoftheDay
TRF=TheRiseandFall
TRFDODO=TheRiseFallofDODO|TheRiseandFallofDODO
TRHMB=TheRoadtoHellMultiverseBook3
TRK=TheRebornKing
TRS=TheRubyintheSmoke|TRyderSmith|TheRulesofSupervillainy|TheRoadtoSevendor|TheRealSherlock
TRSAAO=TheRealSherlockAnAudibleOriginal
TRSASA=TheRoadtoSevendorASpellmongerAnthology
TRT=TheRosetheThorn|TheRampartTrilogy
TRWC=TheRainWildChronicles
TS=TheftofSwords|TerminationShock|TomStechschulte|TheoSolomon|TheSandman|TheScar|TheSiege|TheSilkworm|TheSnowman|TheStand|TheStrain|TheSurvivor|TheSuspect|TheShrine
TSA=TheStormlightArchive
TSACSB=TheStateoftheArtCultureSeriesBook4
TSADCIR=TheShrineADCIRyanMystery
TSAH=TheSuddenAppearanceofHope
TSAII=TheSandmanActII
TSB=ThaumaturgeSpellmongerBook11
TSCTBDV=TheSecretCommonwealthTheBookofDustVolumeTwo
TSDF=TheSecretoftheDarkForest
TSE=TheSagaoftheElven|TheSoundattheEnd
TSF=TheSinsoftheFather
TSG=TheShadowofGods|TheSelfishGene|TheSwordofGod
TSGO=TheSamGunnOmnibus
TSGTFFS=TheSomethingGirlTheFrogmortonFarmSeriesBook2
TSHASNT=TheSpellmongersHoneymoonASpellmongerNovellaTheSpellmongerSeriesBook25
TSINF=TheSecretsoftheImmortalNicholasFlamel
TSJRB=TheSentinelJackReacherBook25
TSK=TheSeeressofKell
TSKHDMT=TheSubtleKnifeHisDarkMaterialsTrilogyBook2
TSKV=TheSharingKnifeVol4|TheSharingKnifeVolume1|TheSharingKnifeVolume2|TheSharingKnifeVolume3
TSKVP=TheSharingKnifeVolume3Passage
TSL=TheShapeofLies|TheSwordoftheLictor|TheSilentLand|TheStrangeLibrary
TSM=TheStoneMan|TheSolitaryMan
TSN=TheShadowintheNorth
TSND=ToSayNothingoftheDog
TSP=TheShadowPolice|TheSecretPlace
TSQ=TheSnowQueen
TSR=TheShadowRising
TSS=TheSpellmongerSeries|TheStarlessSea|TheStoneSong|TheSwordoftheSouth|TheSaintsofSalvation
TSSSB=TheSwordofShannaraShannaraBook1
TSST=TheSoldierSonTrilogy
TSSTSS=TheSaintsofSalvationTheSalvationSequence
TST=TraitorSpyTrilogy|TheSwordofTruth|TheShadowoftheTorturer|TheSingularityTrap|TheSkullThrone
TSVW=TheShortVictoriousWar
TSW=TheSystemoftheWorld|TheShapeofWater
TSWDCIT=TheSixthWindowDCITomDouglasBook6
TSWWL=TheShadowofWhatWasLost
TSYTWWB=TheSeventeenthYearTheWorldWalkerBook3
TT=TheTamuli|TheThirst|TheTrespasser|TheTwelve|ThiefofTime
TTBB=TheTalesofBeedletheBard
TTCC=TheTwelveCluesofChristmas
TTDMS=13ThingsThatDontMakeSense
TTDMSTM=13ThingsThatDontMakeSenseTheMostIntriguingScientificMysteries
TTE=TheThousandEmperors
TTF=TheTowerofFools
TTM=TheTractateMiddoth
TTMC=TheTalesofMaxCarrados
TTMT=TheTawnyManTrilogy
TTMTFE=TheTawnyManTrilogy1FoolsErrand
TTP=TheTinPrincess|TheTimePolice
TTQ=TheTraitorQueen
TTR=TheTunnelRats
TTRT=TheTaintedRealmTrilogy
TTS=TheTrinitySix|TheToweroftheSwallow
TTSS=TinkerTailorSoldierSpy
TTST=TheTraitorSpyTrilogy
TTTISAA=TheTorchThatIgnitestheStarsArcaneAscensionBook3
TTTW=TheTimeTravelersWife
TTV=TheTemporalVoid
TTW=TheTigerintheWell
TUETWWS=TheUnmakingEngineTheWorldWalkerSeriesBook2
TUS=TheUpliftSaga
TVFDT=TheVeryFirstDamnedThing
TVPTGPB=TheValkyrieProtocolTheGordianProtocolBook2
TW=TheWakening|TadWilliams|TempleoftheWinds|TerminalWorld|TomWood|TheWitcher|TheWreckage|TriggerWarning
TWA=TheWarriorsApprentice|TheWellofAscension
TWBM=TheWarofBrokenMirrors
TWC=TheWarlordChronicles
TWF=TheWakingFire
TWG=TheWindupGirl|TheWinterGhosts
TWGO=TheWarGodsOwn
TWH=TheWorldshipHumility
TWIF=TheWorldofIceandFire
TWIFTUH=TheWorldofIceFireTheUntoldHistoryofWesterostheGameofThrones
TWK=TheWinterKing|TheWayofKings
TWM=ThisWasaMan
TWMF=TheWiseMansFear
TWO=TheWheelofOsheim
TWPPP=TheWilfulPrincessthePiebaldPrince|TheWilfulPrincessandthePiebaldPrince
TWS=TheWorthingSaga|TheWizardsofSevendor
TWSASA=TheWizardsofSevendorASpellmongerAnthology
TWSFD=TriggerWarningShortFictionsDisturbances
TWTSB=TheWeaponTakersSagaBooks13
TWTSBAE=TheWeaponTakersSagaBooks13AnEpicFantasyCollection
TWUBC=TheWindUpBirdChronicle
TWW=TheWindintheWillows|TheWomanintheWindow|TheWorldWalker
TWWS=TheWorldWalkerSeries
TXF=TheXFiles
TXFCC=TheXFilesColdCases
TYL=TheYearoftheLadybird
UD=UndertheDome
UM=UndyingMercenaries
UMC=UnaMcCormack
UP=UnicornPoint
UW=UseofWeapons
V=Vengeance|Visitors|Voyager
VA=VictortheAssassin
VB=VincentBugliosi
VEFB=ValkyrieExpeditionaryForceBook9
VG=VoiceoftheGods
VH=VaughnHeppner
VL=VivienneLeheny
VM=VasilyMahanenko|VanessaMoyen|VirtualMode
VR=VeronicaRoth
VV=VernorVinge|VforVendetta
W=Worldquake|Warmage|Wakers|Warbound|Warbreaker|Warriors|Wool|Wyrms
WALWAB=WeAreLegionWeAreBob
WARP=WARP
WARPTRA=WARPTheReluctantAssassin
WB=WilliamBoyd|WilliamBrinkley
WBB=WhentheBoughBreaks
WCD=WilliamCDietz
WCI=WildCardsI
WCIB=WhenaChildIsBorn
WCII=WildCardsII
WCIIAH=WildCardsIIAcesHigh
WCPGW=WhatCouldPossiblyGoWrong
WD=WilliamDufris|WendyDillon|WarwickDavis|WinterDark
WDEMCWS=WhyDoesEMC2WhyShouldWeCare|WhyDoesEMC2andWhyShouldWeCare
WE=WaterforElephants
WF=WillFerrell|WokenFuries
WFPRSB=WeFewPrinceRogerSeriesBook4
WFR=WizardsFirstRule
WG=WilliamGaminara|WakingGods|WarGod|WinterfairGifts
WGTB=WizardGaeanTrilogyBook2
WH=WilliamHope|WintersHeart
WIJ=WhenItsaJar
WJW=WalterJonWilliams
WK=WeKnow
WL=WhiteLies
WM=WhispersfromMirrowen
WMC=WarMaidsChoice
WMEWC=WhileMyEyesWereClosed
WOS=WildernessOtherStories|WildernessandOtherStories
WP=WillPatton|WalkthePlank
WPBGSB=WarofthePosersBadGuysSeriesBook4
WR=WilliamRoberts|WordsofRadiance
WRO=WindRidersOath
WRS=WieldingaRedSword
WRTFAB=WarriorsRansomTheFirstArgentinesBook2
WS=WilliamShakespeare|WayoftheShaman
WSECB=WhiteSilenceElizabethCageBook1
WSS=WayoftheShamanSeries
WT=WheelofTime|WoolTrilogy
WW=WilWheaton|WeaponsandWielders|WilliamWarwick|WinteroftheWorld
WWE=WorldWithoutEnd
WWW=WWW
WWWO=WhenWeWereOrphans
WWWW=WWWWake|WWWWatch|WWWWonder
WY=WatchingYou
X=Xenocide
XS=XeSands
Y=1000Yards
YAJMSS=1000YardsAJohnMiltonShortStory
YM=YannMartel
YN=YoureNext
YS=YaraShahidi
YZ=YearZero
Z=Zodiac
ZG=ZeroG
ZH=ZeroHour
ZQ=ZacharyQuinto
ZR=ZaraRamm
author=author
fullcas=fullcast
or=or
uncredi=uncredited
